{
    "name": "Test Level 10",
    "width": 20,
    "height": 14,
    "playerStart": {"x": 1, "y": 1},
    "grid": [
        "####################",
        "#     ####         #",
        "#  $  #  #  $   $  #",
        "#  #  #  #  #   #  #",
        "#  $  #  #  $ $ #  #",
        "#  #  ####  # # #  #",
        "#  $   @    $ $ #  #",
        "#  #  ####  .......#",
        "#     #  #  #......#",
        "#     #  #   ......#",
        "#  $  ####         #",
        "#                  #",
        "#                  #",
        "####################"
    ],
    "legend": {
        "#": "wall",
        " ": "floor",
        "@": "player",
        "$": "box",
        ".": "target"
    }
}